దీవించావే - సమృద్ధిగా
Deevinchaave - Samruddhiga
పల్లవి
Pallavi
॥ దీవించావే సమృద్ధిగా నీ సాక్షిగా కొనసాగమని
॥ Deevinchaave samruddhiga nee saakshiga konasaagamani
ప్రేమించావే నను ప్రాణంగా నీ కోసమే నను బ్రతకమని
Preminchave nanu praananga nee kosame nanu bratakamani
దారులలో ఎడారులలో - సెలయేరులై ప్రవహించుమయా
Daarulalo edaarulalo - selayerulai pravahinchumayaa
చీకటిలో కారు చీకటిలో- అగ్ని స్తంభమై నను నడుపుమయా
Cheekatilo kaaru cheekatilo- agni stambhamai nanu nadupumayaa

1. నువ్వే లేకుండా – నేనుండలేను యేసయ్య 
1. Nuvve lekundaa – nenundalenu yesayya 
నీ ప్రేమే లేకుండా - జీవించలేను నేనయ్య
Nee preme lekundaa - jeevinchalenu nenayya
 నా ఒంటరి పయనంలో నా జంటగా నిలిచావే 
 Naa ontari payanallo naa jantaga nilichaave 
-నే నడిచే దారుల్లో - నా తోడై వున్నావే  (2) 
-Ne nadiche daarullo - naa todai vunnave (2) 
ఊహలలో నా ఊసులలో - నా ధ్యాస బాసవైనావే 
Oohalalo naa oosulalo - naa dhyaasa baasavainave 
శుద్ధతలో పరిశుద్ధతలో - నిను పోలి నన్నిల సాగమని
Shuddhatalo parishuddhatalo - ninu poli nannila saagamani

2. కొలతే లేదయ్యా - నీ జాలి నాపై యేసయ్య
2. Kolate ledayyaa - nee jaali naapai yesayya
 కొరతే లేదయ్యా – సమృద్ధి జీవం నీవయ్యా
 Korate ledayyaa – samruddhi jeevam neevayyaa
 నా కన్నీరంతా తుడిచావే - కన్న తల్లిలా 
 Naa kannirantaa tudichaave - kanna tallilaa 
కొదువంతా తీర్చావే - కన్న తండ్రిలా   (2) 
Koduvantaa teerchaave - kanna tandrilaa (2) 
ఆశలలో నిరాశలలో – నేనున్నా నీకని అన్నావే
Aashalalo niraashalalo – nenunna neekani annave
పోరులలో పోరాటములో నా పక్షముగా నిలిచావే
Porulalo poraatamulo naa pakshamugaa nilichaave