దోషిగ నన్ను చూడలేక
Doshiga Nannu Choodaleka

నా శిక్ష నీవు పొందినావా
Naa Shiksha Neevu Pondinava

నా తల ఎత్తుటకు - నీవు తలవంచితివే
Naa Thala Ettutaku - Neevu Thalavanchithive

అర్హత నాకిచ్చుటకు - అవమాన అవమానమొందితివే
Arhatha Naakichchutaku - Avamana Avamanamondithive

తండ్రితో నన్ను చేర్చుటకు - విడనాడబడితేవే 
Thandritho Nannu Cherchutaku - Vidanaadabaditeeve 

జీవము నాకు ఇచ్చుటకు - మరణమునొందితివే
Jeevamu Naaku Ichchutaku - Maranamunondithive

నీవే నీవే నీవే దేవా 
Neeve Neeve Neeve Devaa 

నీవే నీవే నా యేసయ్య
Neeve Neeve Naa Yesayya

[Verse1]
పరమును వీడి ఈ భువికి - దిగి వచ్చిన రక్షకుడా 
Paramunu Veedi Ee Bhuviki - Digi Vacchina Rakshakudaa 

మహిమను వీడి నా వెలని - చెల్లించిన ప్రేమామయుడా
Mahimanu Veedi Naa Velani - Chellinchina Premaamayudaa

నే వెదకి రాలేనని సత్యము నెరిగి - నీవే నా దరికి పరుగెత్తితివి 
Ne Vedaki Raalenani Sathyamu Nerigi - Neeve Naa Dhariki Parugettithivi 

దాసత్వము నుండి నన్ను విడిపించి - తండ్రి అని పిలిచే భాగ్యము నిచ్చితివి...ఓ.. 
Daasathvamu Nundi Nannu Vidipinchi - Thandri Ani Piliche Bhaagyamu Nichchithivi...O.. 

[Verse2]
నా స్థానములో నీవే నిలచి - నీ స్థానమే నాకిచ్చితివి 
Naa Sthaanamulo Neeve Nilachi - Nee Sthaaname Naakichchithivi 

సౌందర్యవంతునిగా నన్నే చేసి - సొగసంతా కోల్పోయితివి 
Saundaryavanthunigaa Nanne Chesi - Sogasanthaa Kolpoyyithivi 

నీ బలమంతా నాకే ఇచ్చి - బలియాగముగా నీవు మారితివి 
Nee Balamanthaa Naake Ichchi - Baliyaagamugaa Neevu Maarithivi 

ఐశ్వర్యవంతునిగా నన్నే చేసి - దీనతనే హత్తుకుంటివి
Aishwaryavanthunigaa Nanne Chesi - Deenatane Hatthukuntivi

నా బలమంతా నీవే - నా సౌందర్యము నీవే 
Naa Balamanthaa Neeve - Naa Saundaryamu Neeve 

నా ఐశ్వర్యము నీవే - నీవే నీవే 
Naa Aishwaryamu Neeve - Neeve Neeve 

నా అతిశయము నీవే - నా ఆనందము నీవే 
Naa Athishayamu Neeve - Naa Aanandamu Neeve 

నా ఆధారము నీవే - నీవే నీవే 
Naa Aadhaaramu Neeve - Neeve Neeve 

యేసయ్య యేసయ్య యేసయ్య 
Yesayya Yesayya Yesayya 

యేసయ్య యేసయ్య నా యేసయ్య...
Yesayya Yesayya Naa Yesayya...

యేసయ్య యేసయ్య యేసయ్య 
Yesayya Yesayya Yesayya 

యేసయ్య యేసయ్య నా యేసయ్య...
Yesayya Yesayya Naa Yesayya...
